1222222222222222222223
8000000000000000000004
8000000000000000000004
8000000000000000000004
8000000000000000000004
8000000000000000000004
8000000000000000000004
8000000000000000000004
7666666666666666666665
bbbbbbbbb80000004bbbbb
bbbbbbbbb80000004bbbbb
bbbbbbbbb80000004bbbbb
bbbbbbbbb80000004bbbbb
bbbbbbbbb76666665bbbbb