1222222222222222222223
8000000000000000000004
8000000000000000000004
800b0c0b00000000000004
800d000000000000000004
800b000000000000000004
8000000000000000000004
8000000000000000000004
7666666666666666666665
80000000000000004bbbbb
80000000000000004bbbbb
80000000000000004bbbbb
80000000000000004bbbbb
76666666666666665bbbbb