1222922292229222322223
7666a666a666a666500004
8000000000000000400004
8000000000000000400004
8000000000000000400004
8000000000000000400004
8000000000000000400004
8000000000000000400004
8000000000000000466665
80000000000000004bbbbb
80000000000000004bbbbb
80000000000000004bbbbb
80000000000000004bbbbb
76666666666666665bbbbb