122222222222222222222223
800000000000000000000004
800000000000000000000004
800000000000000000000004
800000000000000000000004
800000000000000000000004
800000000000000000000004
800000000000000000000004
800000000000000000000004
800000000000000000000004
800000000000000000000004
800000000000000000000004
800000000000000000000004
800000000000000000000004
800000000000000000000004
766666666666666666666665